1 0 0 0 0 0 0 0 0 0
0 0 0 0 0 0 0 0 0 0
5 5 0 5 0 4 0 0 0 0
5 0 0 5 0 0 0 0 0 0
5 0 0 5 0 0 0 0 0 0
5 0 0 5 0 0 0 0 0 0
5 0 2 5 2 0 0 0 0 0
5 0 0 5 0 0 0 0 0 0
5 0 0 5 0 0 0 0 0 0
5 4 0 5 0 0 0 0 0 0